#####
#@  #
# #$####
# $  ..#
########
;
#####
#   #
# $ # ###
# $ # #.#
### ###.#
 ## $  .#
 #   #  #
 #@  ####
 #####